euro	euro.bnf
uno	uno.bnf
due	due.bnf
do	do.bnf
tre	tre.bnf
quattro	quattro.bnf
cinque	cinque.bnf
quin	quin.bnf
sei	sei.bnf
sess	sess.bnf
sette	sette.bnf
otto	otto.bnf
nove	nove.bnf
an	an.bnf
dieci	dieci.bnf
dici	dici.bnf
venti	venti.bnf
trenta	trenta.bnf
quar	quar.bnf
anta	anta.bnf
cento	cento.bnf
mille	mille.bnf
mila	mila.bnf
centesimi	centesimi.bnf
e	e.bnf
#	plus.bnf	
NUM	NUM.bnf
/00	00.bnf
---	minus.bnf
XXX	noise2.bnf
???	noise3.bnf
*	noise.bnf

